d 1 3 9 1 5 5 3 d 3 9 5 3 9 3 9 3 9 5 3 9 5 7 9 5 1 5 7 9 5 3 9 5 1 5 5 5 3 9 1 5 5 3 d 1 5 7 9 5 5 1 5 3 9 5 5 1 3 9 1 5 5 7 9 5 5 5 5 5 1 5 5 5 3 9 5 5 5 5 5 5 3 d 1 5 3 9 5 5 7 9 5 5 5 5 1 3 9 1 7 
9 2 e a c 3 d 4 1 6 a b a a c 6 c 6 9 6 8 5 5 6 9 2 9 3 a b c 6 9 6 9 3 b a e a 9 3 c 5 2 9 5 6 9 3 c 3 a e 9 5 2 e a c 5 5 5 6 9 5 5 5 5 6 d 5 3 c 6 9 5 5 5 3 b a 9 6 b a 8 5 5 3 8 7 9 5 3 a a e 8 3 
a e 9 4 7 c 3 d 6 9 6 a a c 3 9 1 3 c 3 c 5 5 3 a e a c 6 8 1 7 c 5 6 a a c 3 a a e 9 3 a a 9 7 a c 5 6 c 3 c 3 a 9 6 9 1 7 9 3 c 3 b 9 5 1 5 5 2 9 5 6 b 9 5 4 6 a a b 8 6 c 3 b c 6 9 6 b c 6 c 3 e a 
c 5 2 9 5 3 c 3 9 6 9 6 a 9 6 a a c 7 a d 1 5 6 c 3 c 3 d 6 c 3 9 5 5 6 8 3 a a 8 5 6 a a a a 9 6 9 5 3 d 4 5 6 e a b a c 3 a 8 3 a 8 6 9 6 d 1 6 c 3 d 4 6 9 5 3 c 6 a a 9 5 6 8 1 7 a 9 4 5 1 7 c 5 2 
9 3 e a d 4 5 2 a d 2 9 6 8 3 e 8 5 3 c 3 a d 1 3 c 5 4 3 9 5 6 c 3 9 1 6 e c 2 c 5 7 c 6 a a c 3 c 3 c 5 3 9 5 5 6 a c 3 c 6 a e a a b c 5 3 c 5 3 8 5 5 3 a b c 1 5 2 a c 3 9 2 e 9 6 c 1 7 a 9 1 7 a 
a 8 5 6 9 3 b a c 7 a a d 6 c 3 a b c 5 6 c 1 6 e 9 3 d 2 c 5 5 3 a e c 5 3 9 6 9 5 3 9 3 a c 3 a 9 6 9 5 6 c 3 d 1 4 3 a 9 3 c 3 a c 2 9 3 c 5 3 a e 9 5 2 a c 3 c 3 e c 3 c 6 e 9 6 d 5 6 9 2 a c 5 6 
a a 9 5 6 a a a d 5 2 a 9 5 5 6 a c 1 3 d 5 2 9 5 6 c 3 c 5 5 5 2 c 5 5 3 a a 9 4 7 a a c 6 9 2 c 6 9 6 9 5 5 6 9 6 9 6 a a a 9 2 a 9 6 a c 3 9 6 c 5 6 9 6 a 9 4 3 c 5 5 6 9 5 5 6 d 1 1 5 6 e c 5 5 3 
a e a 9 3 a a a 9 5 2 a c 3 9 3 a 9 6 c 5 3 e a 9 5 5 6 9 3 d 3 a 9 3 9 6 c 6 c 3 9 6 a 9 5 6 c 3 9 6 9 6 b 9 5 4 3 8 7 a a c 6 a a c 5 6 b a c 5 5 3 d 4 7 c 6 b a 9 5 3 9 2 9 5 5 5 6 e 9 3 9 5 1 3 a 
8 3 a a a a 8 6 a 9 6 c 5 6 e a a a b 9 3 c 5 6 c 5 3 d 2 c 3 a a a a a 9 5 5 3 a c 3 c 6 9 5 7 a a 9 6 d 4 6 9 3 a a 9 6 a d 3 a c 5 5 3 a a d 1 7 c 3 9 5 5 3 8 6 a 9 6 e a 8 5 3 9 3 9 6 c 6 9 6 e a 
a a a a e a a 9 6 c 7 9 5 5 1 6 a a c 6 8 1 7 9 1 7 c 3 a 9 6 a c 6 a a c 3 9 6 c 3 c 5 3 8 5 3 a c 6 9 5 3 9 6 a a e c 3 c 3 c 4 3 b 9 6 c 2 9 6 9 3 a c 3 9 6 a d 2 c 5 3 a e 9 6 a a a d 1 3 c 5 5 6 
a c 6 c 3 a 8 6 9 5 3 8 7 9 6 9 6 c 1 3 e c 1 6 c 5 3 c 6 a 9 2 9 5 6 c 3 a a 9 3 c 3 9 6 a b c 6 9 5 4 3 c 6 9 6 8 5 5 4 3 c 3 b c 2 c 5 3 c 6 9 6 a 8 5 6 c 3 c 5 6 b 9 6 c 3 8 3 a a c 3 a c 1 3 d 3 
c 5 5 5 2 a e 9 6 b c 6 9 6 9 6 9 3 e c 1 3 c 5 5 7 c 1 7 a e c 4 3 9 1 6 a c 6 c 5 6 c 1 4 4 5 3 c 7 9 6 d 3 a d 2 9 3 b 8 7 a 8 3 c 5 3 c 5 5 6 9 6 c 3 9 5 4 3 9 5 4 6 9 1 6 e 8 6 8 7 a c 3 a c 5 2 
9 5 1 3 a c 5 6 d 4 1 7 c 3 c 5 6 c 5 3 e a 9 5 5 5 3 8 3 c 5 3 b a a e 9 6 9 5 5 5 5 3 e 9 5 3 c 5 5 6 9 5 6 c 3 e a a a a 9 6 a c 5 7 a 9 1 5 7 a d 5 6 c 1 3 e a 9 5 3 e c 5 3 c 3 c 3 a b a a d 5 6 
c 7 a a a 9 5 3 9 3 c 1 3 c 1 5 5 5 7 c 3 c 4 7 9 5 6 e 8 3 9 6 8 6 c 3 a b a 9 3 b 9 6 9 6 9 6 b 9 1 5 6 9 1 7 c 5 6 a c 6 a b 8 5 5 5 6 e a 9 3 c 5 3 9 3 a c 3 a a b c 5 3 9 6 9 4 7 a a 8 6 c 5 5 3 
9 5 6 a a a d 4 6 c 3 a 8 3 c 5 5 5 1 3 c 5 3 9 6 9 5 3 a a c 3 c 7 9 6 c 2 c 6 a c 4 3 a b a 9 6 a c 5 5 6 c 1 3 9 7 c 5 5 6 a a d 1 5 1 3 a a c 1 7 c 6 a a b a a a a 9 3 a a d 2 9 3 a a c 5 5 3 9 6 
a 9 3 a a c 3 9 3 b a a a e 9 5 1 7 a c 7 9 6 a 9 6 9 6 a c 3 c 3 9 6 9 3 c 3 b c 3 b a a 8 6 a 9 6 9 5 5 5 3 a c 2 9 5 1 5 5 2 c 3 e 9 6 a 8 6 b c 3 9 5 6 a a a c 6 8 6 c 6 8 3 e a a a c 3 9 3 e c 3 
c 6 a a c 3 a a c 6 a a c 3 a 9 2 9 6 9 3 c 3 a a 9 6 9 2 d 4 7 a 8 5 6 c 3 a a 9 6 a c 6 a b 8 6 9 6 9 5 3 a a d 6 a b c 5 3 c 3 c 3 a 9 6 a 9 2 b a a d 5 4 6 c 1 7 c 5 3 9 6 a 9 6 c 4 7 c 6 a 9 5 6 
9 5 6 c 3 c 6 a 9 5 6 c 3 c 6 a a c 5 6 8 7 a a a c 3 a e 9 5 5 6 c 3 9 3 c 4 6 c 3 c 1 3 a 8 4 5 6 9 6 d 6 a c 5 5 4 4 5 7 a 9 6 b c 6 a d 4 6 c 6 a c 5 5 5 3 9 6 9 3 9 6 c 7 a 8 5 3 9 3 9 3 a c 5 3 
c 3 d 5 4 3 9 2 a 9 5 3 8 5 7 a c 5 5 3 c 5 6 a a d 4 6 9 6 9 5 5 3 e a c 5 3 9 5 6 9 6 a a e 9 3 d 4 5 1 5 6 d 3 9 3 9 5 3 a c 5 4 1 7 c 5 5 5 5 3 8 5 5 3 b a 8 5 6 c 6 9 5 5 6 c 3 c 6 c 6 a c 5 3 a 
9 6 9 5 3 c 6 a c 6 9 6 e 9 3 a 9 5 7 a d 5 1 2 c 3 9 5 6 9 6 d 3 a 9 6 d 3 a c 3 d 2 d 6 a 9 6 a 9 5 3 c 3 9 3 a a c 6 9 6 8 3 d 5 6 9 5 1 3 b 9 6 a b 9 4 6 a c 3 d 5 1 2 d 5 1 5 6 9 3 9 3 c 1 3 a a 
8 5 4 7 c 3 9 6 9 3 c 5 3 a c 6 8 5 3 c 5 3 a a 9 6 c 3 d 0 5 3 8 6 a 9 5 6 c 3 c 3 a 9 3 c 6 9 6 a 9 6 d 4 6 a a a 9 7 a b a c 5 5 5 6 b a a a a 9 6 a a b 9 6 9 6 9 3 e c 5 3 c 5 3 a c 6 c 5 2 e c 2 
c 5 7 9 5 6 c 3 e c 5 3 c 6 9 5 6 9 6 9 5 6 e a c 1 3 c 3 e 9 6 c 3 a c 5 5 3 a 9 6 a a c 5 3 a 9 2 c 5 3 9 7 c 2 a 8 5 6 a a d 5 3 9 1 6 a c 6 a a b 8 6 a c 3 c 1 6 c 5 5 1 6 9 3 a c 5 1 5 3 a 9 3 a 
9 5 3 c 5 3 9 6 9 1 5 4 5 3 c 3 b c 3 c 5 3 9 6 9 6 a b c 3 a d 3 a 8 5 5 3 c 4 6 9 2 a b 9 2 a e 8 5 3 a c 5 5 6 a a d 1 2 c 5 3 c 6 a 9 6 9 5 6 a 8 4 5 4 7 c 3 a 9 5 3 9 6 9 6 a e 9 3 a b a e a c 6 
c 3 c 5 5 6 c 3 a e 9 5 3 c 7 c 0 7 c 1 7 a 8 3 8 3 8 6 9 6 a 9 2 a c 5 3 c 5 5 3 e a c 2 a e c 3 8 7 a c 5 3 9 5 6 c 3 a c 1 7 c 5 3 a a 9 6 9 5 6 c 3 9 5 5 1 6 e c 3 a c 3 a b c 5 6 a c 6 c 5 4 3 b 
9 6 9 3 9 3 b 8 6 9 6 b c 3 9 5 6 9 3 a 9 6 e a a a e 9 6 9 6 a a a 9 3 c 3 9 5 6 9 2 b a c 3 9 6 e 9 6 9 3 a c 3 b 9 6 c 3 c 3 9 5 4 6 a c 3 a 9 5 5 6 a 9 3 e 9 1 7 a c 3 a a 8 7 9 3 c 3 9 5 3 b a a 
8 3 a c 6 a a a 9 6 d 0 7 c 6 9 3 a 8 6 c 3 9 6 e 8 3 a d 2 d 2 a c 6 c 3 e c 3 d 2 c 6 a b c 6 d 1 6 9 2 e a 9 6 8 6 d 1 4 7 c 4 7 9 5 6 9 6 a c 7 9 3 a a c 5 6 a 9 6 b a e a 8 5 6 a 9 6 a 9 6 a a a 
a c 6 d 3 a a a c 5 3 c 3 9 5 6 a a e 9 3 a 8 5 3 e c 4 5 6 9 6 c 7 9 3 a 9 3 a 9 2 9 3 a 8 3 9 5 6 9 6 e 9 6 c 3 a 9 3 e 9 3 9 5 1 6 9 3 c 3 a 9 5 6 8 6 c 5 3 b a c 3 a a 9 6 8 7 9 2 c 5 6 c 3 a c 2 
c 3 9 3 a a c 2 9 7 a 9 6 c 5 3 a a 9 6 a a c 3 c 3 9 5 3 9 4 5 5 3 a a c 6 a a a e a a c 6 c 6 9 7 8 5 5 6 9 3 a c 6 c 5 6 a a 9 6 9 6 c 5 6 a a d 5 6 9 3 9 6 a c 3 a a a c 3 e 9 6 a 9 5 7 9 6 c 5 6 
9 6 a c 2 c 3 c 6 9 6 c 5 1 5 6 a c 6 b c 6 d 4 7 c 6 9 6 8 5 5 7 8 6 c 1 7 c 6 8 3 a c 5 5 5 3 8 5 6 9 5 5 6 a c 5 5 5 3 d 4 6 c 3 c 3 d 1 5 6 c 5 5 5 6 a a 9 2 9 6 c 2 c 5 6 9 6 9 4 6 9 3 c 1 5 5 3 
a 9 6 b a b c 5 3 c 5 5 3 c 3 b a 9 5 4 5 1 3 9 5 5 5 6 d 6 9 5 3 8 5 7 c 1 7 9 6 a c 3 9 1 7 c 6 d 1 6 9 5 7 c 5 5 3 9 2 9 5 5 3 c 7 c 3 a 9 5 5 5 1 7 9 2 a e a c 5 3 a d 5 5 2 9 4 7 9 6 c 3 c 5 3 a 
c 6 9 4 4 4 7 9 6 9 5 5 6 9 4 6 c 2 b 9 5 6 c 6 d 1 5 5 5 5 6 b a e 9 3 9 2 9 6 b c 5 6 e 8 5 1 5 3 8 3 8 5 1 1 5 7 a a a c 5 3 c 3 9 5 6 c 4 5 1 7 a 9 6 e a 9 2 9 5 6 c 3 9 5 6 a 9 5 6 9 3 a d 5 6 a 
9 7 a 9 5 3 9 2 9 6 9 5 5 4 7 9 3 c 2 c 5 3 9 5 3 c 3 9 5 5 1 6 c 1 6 c 6 e a 9 2 9 5 5 3 c 3 a b a a a a b a e 9 5 6 a c 7 9 6 b a c 3 9 1 5 3 e 9 2 c 3 9 4 6 a a 9 5 5 6 a 9 3 a c 3 9 6 c 4 5 5 3 a 
8 5 6 a d 2 a a a d 6 9 5 5 3 a c 3 a 9 5 6 8 3 c 5 6 8 5 7 8 1 7 a 9 5 5 5 6 a c 6 d 5 4 3 a a a a e a c 2 c 5 6 9 3 c 5 5 2 d 2 8 3 a e a b c 3 a c 3 c 6 9 3 a a a b 9 1 6 a e a b a e 9 5 3 b 9 6 a 
a 9 3 c 3 c 6 a a 9 3 c 3 9 6 a 9 6 e c 3 d 2 c 5 5 3 e 9 3 e 8 5 6 c 3 9 5 5 4 3 9 5 5 3 a e a a a 9 6 b a 9 3 9 6 c 5 5 3 c 3 a a e c 3 a 8 7 a 8 3 c 5 7 a a e 8 6 c 6 a d 4 5 4 6 c 5 6 9 6 a a 9 6 
c 6 e 9 6 9 7 a c 6 c 5 6 c 5 6 a 9 5 3 c 3 c 5 3 9 2 9 6 c 3 a d 1 7 a c 5 3 9 6 a d 3 a c 5 6 a c 6 9 2 a a c 6 d 5 3 9 6 9 4 6 a 9 3 c 6 a 9 6 a a 9 5 3 a c 3 a d 1 3 a 9 5 5 5 3 9 5 5 6 b 8 6 c 3 
9 5 5 6 b 8 3 a 9 3 9 3 9 1 7 9 6 c 3 a 9 6 b 9 6 a e a b 9 6 c 3 a 9 6 9 3 a c 3 c 5 2 a 9 3 d 4 1 5 6 e c 6 9 5 1 5 2 c 3 e 9 5 6 a 8 7 9 4 6 9 6 a c 3 c 6 9 6 c 3 a a a c 5 3 b c 6 9 7 9 4 6 9 5 2 
a 9 5 3 8 6 a 8 6 c 6 e a c 5 6 9 5 6 c 6 9 6 c 3 c 3 c 2 c 3 d 4 2 c 5 6 a a b c 1 3 a c 6 c 5 3 8 3 9 5 1 7 c 3 c 3 c 7 c 3 8 5 5 6 c 5 6 9 5 6 b c 3 a 9 3 a 9 3 c 6 c 2 9 3 a a 9 5 4 5 6 9 7 8 3 e 
a e 9 6 c 3 a a 9 5 5 5 6 d 5 1 6 9 5 7 9 2 9 5 6 b c 3 a b c 5 3 c 5 1 7 a c 2 b a e a 9 3 9 7 a a c 6 b c 5 3 c 3 c 5 5 3 a c 5 5 5 5 3 b c 5 3 a 9 6 c 6 a a e c 5 5 3 a e a a c 4 3 9 7 9 2 9 6 c 3 
8 3 c 5 5 6 a a a 9 5 5 1 5 3 a d 4 5 5 6 a c 3 d 4 3 a a c 1 7 c 3 9 6 9 6 9 4 6 c 5 4 2 c 6 9 6 a 9 5 2 9 5 4 7 a 9 5 7 a c 5 5 3 9 3 a c 3 9 4 6 c 1 3 b a a 9 5 5 3 c 4 5 6 c 3 9 6 8 5 6 c 6 9 5 2 
a c 5 5 5 3 8 6 a a 9 3 a 9 6 c 3 9 5 5 3 a 9 6 9 3 a a c 3 a 9 5 6 8 7 c 3 e 9 5 5 3 d 6 9 5 6 b a c 7 a c 5 3 9 6 c 1 3 a 9 5 5 6 e c 4 3 c 4 3 9 5 2 c 6 a a c 3 9 4 5 5 5 3 9 6 c 3 c 3 d 1 7 a 9 6 
e 9 5 5 5 2 e 9 6 e a a a a 9 3 c 6 9 5 6 8 6 9 6 a a 8 7 c 2 c 3 9 6 9 3 c 3 a 9 3 c 5 5 6 d 1 6 c 5 3 8 5 3 a c 5 3 e a a a 9 5 5 1 5 3 c 3 d 6 c 3 a 9 5 6 a 9 2 e 9 5 3 d 4 6 d 3 a d 4 5 2 9 6 c 3 
9 6 d 1 5 6 9 6 9 1 6 c 6 a a c 5 5 6 d 3 c 3 a b a a a 9 3 a 9 6 c 7 a 8 7 a a a a d 1 5 5 5 2 9 5 3 c 6 9 6 c 1 7 a 9 6 a a e 9 5 6 9 6 b a 9 5 5 6 a c 5 3 c 6 e 9 6 b c 3 9 1 5 6 c 3 9 5 6 a 9 3 a 
8 5 3 a 9 3 c 3 e 8 3 b 9 6 c 3 9 1 5 5 6 9 4 6 c 0 6 c 6 c 6 a 9 3 9 6 c 5 6 a a c 3 a b 9 3 a a b 8 3 9 6 d 3 c 5 6 c 3 a c 5 6 9 5 6 d 2 a a b 9 3 a 9 3 a 9 5 5 6 d 4 3 a e 8 5 1 3 a c 1 7 c 6 a a 
c 7 a a a 8 7 c 3 e a a a 9 3 a a e 9 3 9 6 9 5 3 e 9 3 9 3 9 6 a c 6 d 5 5 1 2 a 9 6 a c 6 c 6 a a a a a 9 3 8 5 5 3 9 6 c 1 5 7 c 5 5 3 a a a c 6 8 6 a e a c 5 3 9 5 5 6 c 3 e 9 6 a c 3 a 9 5 5 6 a 
9 5 6 a a c 5 3 c 5 6 a c 6 c 6 8 3 a c 6 b a d 4 5 6 c 6 a c 3 c 5 3 9 5 3 e a a a 9 2 9 3 9 5 4 6 a a c 6 c 6 9 5 6 a 9 3 c 5 1 7 9 5 6 8 6 c 5 3 a 9 2 9 6 9 5 6 c 5 5 5 3 c 3 a d 2 b a a a 9 3 9 6 
c 3 9 6 a b 9 4 5 3 d 4 1 5 3 9 6 c 6 d 1 6 c 3 9 3 9 5 5 6 9 2 9 3 c 6 b c 5 6 a c 6 e a c 6 9 7 9 6 a 9 5 3 9 6 9 5 2 a c 3 9 2 9 6 9 3 c 3 9 5 6 c 6 a c 3 a 9 1 5 3 9 5 0 7 a c 3 c 6 a e c 6 a c 3 
9 6 c 7 a a a 9 3 c 5 5 6 b a a 9 5 5 5 2 9 5 6 a e a b 9 5 2 e a c 5 5 4 5 1 3 8 3 9 3 c 1 5 6 9 6 b c 2 d 6 c 5 6 9 6 c 3 c 2 e c 3 e 8 7 a a 9 3 9 5 6 9 6 a a a d 4 6 d 6 9 6 9 2 9 3 c 5 5 3 c 3 e 
8 5 5 5 4 6 a a a 9 5 7 9 2 a c 6 9 5 3 a a 9 3 8 3 a c 4 3 c 5 2 9 5 5 3 b a a e c 6 8 5 6 9 3 a 9 4 5 6 9 1 5 5 3 a 9 3 c 3 e 9 3 c 3 8 3 c 6 a e c 5 3 c 3 a a c 5 5 5 3 9 6 9 6 e a c 1 5 3 c 3 8 3 
a d 5 3 9 5 6 a a a 9 5 6 c 6 9 3 a 9 2 a a a c 6 c 4 5 3 a 9 3 a c 3 9 6 a a c 5 5 3 c 5 7 a c 6 e 9 3 9 6 c 5 3 e a a c 3 c 5 6 c 5 6 a c 5 5 4 5 1 7 a b c 6 c 5 5 7 9 2 a d 2 9 3 a b c 3 c 7 a e a 
a 9 5 6 a 9 3 a c 6 c 3 9 5 5 6 c 6 a e a a c 5 7 9 3 9 6 e a a c 3 a c 5 6 c 5 3 d 4 3 9 5 6 9 5 5 6 c 6 9 5 3 a 9 6 c 3 a 9 3 d 1 5 3 8 5 5 7 9 3 8 3 a 8 3 9 5 5 5 5 6 a c 3 8 6 c 4 4 7 c 3 9 4 5 6 
a a 9 5 6 a 8 6 9 3 9 6 a 9 3 d 1 3 a 9 6 a 9 5 5 6 a c 5 5 6 a b a a 9 5 5 1 5 6 9 3 a c 5 3 a d 1 5 1 7 c 3 c 2 a 9 3 a a a c 3 c 3 c 6 9 5 5 6 a e c 4 6 a c 1 3 9 5 3 e 9 6 a 9 5 5 5 5 3 a a b 9 3 
8 6 a d 5 2 e 9 6 c 4 7 c 6 c 5 6 a c 6 b c 6 9 3 9 6 9 5 3 9 6 a a a a d 1 6 9 5 6 a c 5 3 c 4 5 6 d 6 9 3 c 3 e c 6 c 6 c 6 b a 9 6 b 9 6 d 5 3 a 9 3 d 3 c 3 e a a d 4 5 6 b a c 5 5 1 7 a 8 6 a a a 
a 9 6 9 3 c 5 4 1 5 7 9 1 5 1 7 9 6 9 3 8 5 7 a c 6 b a 9 6 a d 4 4 6 c 3 a b c 3 9 6 d 5 4 5 5 5 5 5 3 a c 3 c 3 9 5 5 3 9 3 8 6 c 5 2 c 5 5 3 a a a c 3 8 3 a 9 2 c 3 9 5 5 2 c 3 9 3 a 9 6 c 5 6 a a 
e c 3 a c 5 5 3 e 9 5 6 a 9 6 9 6 9 6 a a 9 5 6 b 9 2 a c 5 6 9 3 9 5 5 6 a 8 3 a c 3 9 5 3 9 5 3 d 5 4 6 9 6 9 2 a d 3 c 6 c 6 9 5 5 6 9 5 3 a a a a 9 6 e c 4 6 a 9 6 a 9 3 a 9 6 a a a c 3 9 5 5 6 a 
9 5 6 c 3 9 3 c 3 c 5 3 a c 3 a d 2 b c 2 a 9 3 a a c 6 9 5 1 6 c 6 d 5 3 a a a a b c 6 b c 6 b c 5 3 b 9 6 d 2 a c 5 4 3 b 9 3 c 5 3 9 6 9 6 a 8 6 a a 9 5 5 3 d 2 c 3 a a e a a d 2 a c 3 c 4 5 5 7 a 
8 5 1 3 c 6 c 3 c 3 9 6 c 3 a a 9 6 8 5 6 a a a a a 9 5 2 d 6 9 3 d 1 5 6 a e a c 2 d 3 8 5 5 0 5 7 a c 4 5 3 a e 9 1 3 a a a a 9 5 6 c 3 c 3 a a 9 6 a c 5 3 c 3 a b a a c 5 6 a 9 6 c 3 a d 3 9 5 5 2 
a b a c 7 9 3 a b c 6 9 5 6 a c 6 9 6 9 7 c 6 a 8 6 e 9 6 9 5 6 c 3 a 9 3 a 9 4 7 c 3 8 6 d 3 c 5 3 c 5 3 b a c 5 6 a a a c 6 c 4 3 b 9 6 b a a a c 3 a 9 5 6 b a c 6 a c 5 5 5 4 6 9 3 e 8 5 6 a 9 3 a 
c 2 c 5 5 6 c 6 8 5 3 a d 3 c 3 9 6 9 4 5 1 7 a c 5 5 2 9 6 b 9 3 a a a c 6 c 3 9 5 6 c 3 9 0 5 7 8 3 9 6 a c 5 3 9 6 e c 5 5 3 b c 2 c 3 a c 6 c 5 6 a c 5 3 a c 5 3 a 9 5 5 5 5 5 6 c 3 a 9 5 2 a a e 
d 4 5 5 5 3 d 5 6 9 6 c 3 c 5 6 a b c 3 b c 3 c 5 5 3 a a d 2 a c 6 8 6 9 5 1 6 a 9 1 7 c 6 a 9 3 a a c 3 c 5 5 4 2 9 5 1 7 9 6 8 5 6 9 6 8 3 d 5 1 7 c 5 5 6 a 9 5 6 a c 3 d 5 1 3 b 9 2 a c 3 e a c 3 
9 3 9 3 d 0 5 5 5 6 9 3 c 3 9 5 6 8 5 6 c 3 8 5 7 9 6 e a 9 6 a d 3 a d 6 9 2 9 6 a c 5 5 5 6 a a a c 3 c 5 5 3 9 6 c 3 c 3 a d 4 5 7 a 9 6 c 5 3 c 1 5 1 3 9 6 c 3 9 4 3 a 9 5 6 a a a a c 3 c 5 6 b a 
a c 6 c 3 a 9 5 1 5 6 c 5 6 c 5 3 a d 1 1 6 a 9 5 6 9 5 6 8 3 c 3 c 4 5 1 6 e c 3 c 5 5 7 9 5 6 a a b c 1 3 9 6 c 5 3 a b c 6 9 5 5 5 6 a d 5 5 4 3 e 9 6 a c 5 3 a 8 3 e c 2 d 5 2 a a c 3 a d 1 5 6 a 
a 9 5 7 a e c 3 e 9 5 5 5 1 5 3 a c 5 6 a 9 6 c 5 5 6 b 9 6 8 7 a 9 3 d 6 9 5 3 a 9 5 5 5 6 9 5 6 c 4 7 a a c 5 3 d 6 a c 5 1 6 9 7 9 5 2 9 5 3 b a 9 6 9 6 9 5 6 a e a 9 5 6 9 3 c 6 a 9 6 c 3 a 9 5 2 
a a 9 3 8 5 5 2 9 6 d 1 7 c 3 a c 5 3 9 6 c 1 3 d 3 9 4 6 9 6 9 6 a c 5 5 6 b a c 6 9 5 1 7 a 9 5 3 9 3 a c 3 b c 3 9 6 9 3 c 3 a 9 6 9 6 8 7 a 8 6 a d 2 9 6 9 3 a 9 6 c 3 9 6 c 5 3 a e 9 5 6 a c 3 a 
a a a a a 9 3 a c 3 9 2 9 3 a a 9 3 a c 3 9 6 c 5 6 a d 3 c 3 c 5 6 9 5 1 5 2 c 5 5 6 b c 5 6 a b c 6 c 6 b 8 4 7 a c 3 a c 5 6 8 4 7 8 5 6 9 6 a d 4 3 c 6 9 6 c 6 c 1 3 a a 9 3 d 4 2 9 6 9 3 a 9 6 a 
a c 6 c 6 a a c 3 c 6 a a c 6 8 6 e a b a c 3 9 5 3 c 1 4 7 a 9 5 5 6 9 6 9 6 9 5 5 5 4 5 5 1 6 8 7 9 1 5 2 a 9 5 4 7 a a d 1 7 a 9 3 c 3 b a b c 5 3 a 9 5 6 9 5 1 5 6 e a c 6 c 3 d 6 a d 2 c 6 a d 6 
8 5 5 5 5 6 a 9 6 b 9 6 c 3 d 6 9 5 6 c 2 b a 8 7 a 9 6 9 3 a a 9 5 7 c 3 a b c 5 3 b 9 5 5 6 d 0 3 a a 9 6 a c 3 9 3 a 8 3 a 9 6 a c 3 a a a 8 5 5 4 2 c 5 3 c 7 a 9 5 5 6 d 1 3 c 5 5 0 5 6 9 1 6 9 3 
c 5 5 3 9 5 6 c 5 2 a 9 7 c 3 9 6 d 1 3 c 2 a a 9 6 a 9 6 c 6 a c 5 3 9 6 c 4 3 b c 2 c 5 3 9 3 e c 6 a c 3 c 3 a a c 6 a a c 2 b c 3 a c 2 a e 9 5 3 a b 9 6 9 1 6 a b 9 1 5 6 e 9 5 3 e 9 3 a e 9 6 a 
9 5 3 e c 3 9 1 7 a c 2 9 5 6 a 9 5 6 a d 2 c 6 a 9 6 c 5 1 3 c 5 1 6 c 3 d 5 0 6 9 4 5 7 a a c 5 5 1 6 d 6 9 6 c 6 b 9 6 c 3 a a 9 6 a d 6 c 1 6 9 6 c 6 c 3 a a 9 6 a a c 3 9 5 6 b c 5 6 a c 3 a b a 
c 3 c 5 3 a a c 5 6 9 6 c 5 5 6 a 9 3 c 3 a b 9 6 a 9 5 3 a 8 5 3 a 9 3 c 5 3 e 9 4 7 9 5 6 a 9 5 5 6 9 5 3 a 9 5 7 8 6 9 3 a c 6 a b c 5 5 3 c 7 8 5 5 5 5 4 6 e a 9 4 6 9 2 a 9 3 8 3 9 3 c 3 c 4 6 a 
9 6 9 3 c 6 a d 3 9 6 d 1 3 9 3 c 2 a b a c 6 8 5 6 a b a e c 3 e a a c 5 5 6 9 6 9 5 6 9 5 6 a 9 5 3 c 3 c 4 6 9 3 a d 2 e c 5 3 c 4 5 3 b c 5 3 a 9 1 5 7 9 5 5 6 c 3 b a a a a c 6 c 6 a b c 3 9 5 2 
a d 2 e 9 3 c 5 2 c 3 9 6 c 6 c 3 e a c 2 9 3 a b 9 6 8 4 5 5 6 9 6 a 9 3 9 3 a 9 6 d 3 8 5 3 e c 3 8 7 c 3 9 5 6 a c 3 c 3 9 3 8 5 5 7 c 2 9 3 a c 6 e 9 5 4 5 5 5 3 c 6 a e a a 9 3 9 3 c 0 7 a a 9 6 
c 3 a 9 6 c 1 3 a 9 6 a 9 3 d 3 c 3 8 3 c 6 a a a a 9 6 9 5 5 5 6 9 6 a c 6 a a c 5 3 c 6 9 6 9 5 6 a 9 5 6 c 5 3 c 3 a 9 6 a a c 5 3 9 3 8 6 e a 9 5 5 6 b 9 3 b 9 4 5 5 2 9 2 c 6 a e c 5 6 9 6 a c 3 
9 6 a 8 5 7 a a a a 9 6 a c 5 2 9 6 e c 1 3 a a a a 8 7 c 5 5 3 b c 5 4 1 7 a a 9 7 a 9 3 c 1 6 9 7 c 6 b 9 3 9 6 b c 6 8 5 6 c 3 9 6 a c 6 9 3 8 6 9 1 1 6 a a 8 6 9 3 b a a e 9 3 8 5 5 5 5 6 d 2 b a 
a d 4 6 9 5 6 a a c 6 d 4 3 d 6 a 9 5 3 e a a a a a e 9 5 5 5 4 4 7 9 3 e 9 2 a c 3 c 6 c 3 a d 4 1 3 d 4 6 a c 5 4 5 3 a b 9 5 2 c 5 4 7 9 6 a a d 6 a e 9 6 a e 9 6 a a a c 5 6 a c 5 5 5 3 d 1 6 8 6 
8 5 5 3 8 5 3 a a d 1 5 3 a 9 5 6 c 3 c 5 6 a c 6 c 5 4 5 3 b 9 5 5 6 c 3 a e c 5 2 b 9 5 6 a 9 5 6 c 3 9 5 6 9 5 3 9 6 c 2 c 3 c 3 9 3 9 6 b a c 5 3 c 3 a 9 6 9 6 b a a c 5 3 b a 9 3 9 3 a 9 6 b c 3 
a 9 5 6 a 9 6 e c 3 c 3 c 2 a 9 3 9 6 9 1 3 c 3 9 3 9 5 3 c 6 c 5 3 d 1 6 c 1 5 5 6 a c 3 9 6 a 9 1 7 a c 3 9 6 b c 6 b 9 6 b a 9 4 6 e a 9 4 6 9 7 c 5 2 a c 3 a d 0 6 c 5 5 4 6 8 6 a a a a a d 0 7 a 
a c 5 3 a c 5 5 3 a 9 2 d 6 c 6 c 6 b a a a 9 6 a a a d 4 5 5 5 3 8 3 c 5 3 a 9 3 d 2 9 6 c 5 6 a c 3 a 9 2 c 5 2 9 5 6 a 9 2 a 8 7 9 5 6 a d 3 8 5 3 9 6 a d 2 c 3 a d 1 5 5 5 3 e 9 6 e a c 6 9 2 9 6 
c 3 9 6 c 5 5 7 8 4 6 e 9 5 1 5 7 9 2 a a a a 9 2 a c 3 9 5 3 9 6 a a 9 5 6 c 6 c 5 2 a 9 3 d 5 4 7 a a a c 5 3 a c 1 5 4 6 e a a 9 6 d 3 c 3 8 4 7 a a b c 3 c 5 6 c 3 a d 1 3 a 9 6 9 5 6 9 5 2 a c 3 
9 6 c 3 9 5 5 3 e 9 5 3 c 3 a 9 5 6 c 6 a e a a a c 5 6 e 9 2 a 9 6 a a d 3 9 1 7 9 6 c 6 c 5 5 3 9 6 c 6 9 5 6 c 3 c 3 9 5 1 6 e a 9 1 2 9 6 c 3 9 6 a 8 7 c 5 3 d 3 c 6 9 6 e c 6 b 8 3 9 4 7 a a b a 
a 9 7 a a 9 3 a 9 6 b c 5 6 a c 5 5 5 3 c 5 6 a c 5 3 9 1 6 e a a 9 6 c 3 8 6 a 9 6 9 3 9 5 5 5 6 8 5 3 9 6 9 5 5 6 b a c 3 a 9 5 6 a a a c 3 d 6 a 9 6 8 3 9 5 6 9 4 5 3 c 5 5 5 3 8 6 c 6 9 5 6 8 6 a 
a c 3 c 6 a c 2 a d 4 5 3 9 4 5 5 5 7 a 9 5 3 c 5 3 a a e 9 3 a a a d 3 a a b c 6 9 6 a 8 5 5 3 d 4 3 a c 3 a d 5 5 4 4 3 a e a 9 7 a a c 7 a 9 1 6 a 9 6 a a d 5 4 1 3 c 5 5 5 5 2 a d 3 9 6 9 5 6 9 6 
c 5 2 9 3 a d 6 c 5 3 9 6 a 9 5 5 5 5 6 a 9 6 9 5 6 a c 5 6 c 2 a c 3 a a a c 3 9 6 9 6 e 9 3 8 3 9 6 c 1 6 c 3 9 3 9 3 e a 9 6 8 5 6 c 5 5 6 a e 9 6 c 3 a c 5 5 3 e a 9 3 9 3 9 6 c 5 2 a d 2 9 7 c 3 
d 5 6 a c 2 9 5 5 5 4 6 9 2 c 3 b 9 5 3 a c 3 a 9 5 6 9 3 9 3 a e 9 6 a a c 5 6 a b a 9 1 6 a a a a 9 3 c 1 7 a a a a c 5 6 a b a 9 1 5 3 d 5 2 9 6 9 3 e c 5 1 7 c 3 a a c 6 a c 3 9 5 6 c 3 a c 1 7 a 
9 5 5 6 9 6 a d 1 3 9 5 2 c 7 a a a b a a b c 6 c 5 5 6 c 6 a c 5 6 d 2 c 5 3 9 6 a a e a 9 6 e a a a a d 6 9 6 a a c 5 3 9 6 8 6 a a b c 5 3 a a 9 6 c 5 5 3 a 9 5 6 8 6 9 3 8 3 e a 9 5 5 6 c 1 6 9 6 
8 3 9 7 a 9 6 9 6 e a b a 9 3 a 8 4 6 8 6 c 1 3 b 9 5 5 5 5 6 9 1 5 5 4 5 3 c 6 d 2 c 5 6 a 9 5 6 e a c 5 3 a d 2 a 9 5 2 a 9 6 d 6 a 8 1 7 a a a a 9 5 1 7 8 6 c 5 3 e 9 6 a a c 5 6 c 3 9 5 3 a 9 6 b 
a a c 5 6 c 5 2 9 1 6 c 6 a c 6 a 9 3 8 5 5 6 c 6 c 3 9 5 5 3 e c 3 d 1 3 c 5 5 5 2 9 5 3 a a 9 5 5 4 5 7 a c 5 6 c 6 9 6 a c 5 5 5 6 e a 9 6 c 4 6 8 3 e 9 6 9 3 9 2 9 4 7 a e 9 5 3 9 6 a b a e a 9 6 
a c 5 5 1 5 3 a a e 9 5 3 c 3 9 6 a a a 9 5 5 5 5 3 a a b 9 6 9 5 6 9 6 8 5 5 7 9 6 a 9 6 a 8 4 5 7 9 5 3 c 1 1 7 9 3 a b c 5 3 b 9 1 1 6 c 5 5 3 b a c 5 6 b a c 6 a a 9 3 c 5 6 9 6 a 9 4 6 a 9 6 8 3 
a 9 5 3 c 3 e a c 5 6 b a 9 6 c 7 a a e c 3 9 3 9 6 a c 2 a 9 6 9 1 6 d 6 9 5 3 c 3 e a 9 6 e 9 3 9 6 d 4 3 a c 5 6 c 4 4 7 9 6 a a a e 9 5 3 9 6 c 4 5 5 5 6 a d 5 6 a a c 5 5 3 c 3 8 6 9 5 2 c 3 a a 
c 6 9 6 9 6 9 6 9 1 3 a c 6 9 1 5 6 c 5 5 6 e a a 9 4 5 6 a a 9 6 c 3 9 5 6 b c 3 c 5 2 a d 1 6 a 8 5 3 9 6 c 1 7 9 5 5 3 9 6 d 4 6 a 9 4 7 a a 9 5 5 5 3 9 1 6 9 5 5 6 c 3 9 7 c 5 6 c 3 c 3 e 9 6 a a 
9 5 4 7 c 3 c 3 e a c 4 5 3 a c 5 3 b 9 3 9 1 6 a 8 7 9 3 a a c 3 b c 6 d 1 4 7 c 3 9 6 c 5 6 b a c 7 a c 5 3 e 9 6 b 9 6 8 5 5 5 3 8 6 9 5 2 a c 3 d 5 4 2 e 9 6 9 7 9 5 6 8 5 1 3 b 9 6 b a 9 6 d 6 a 
a 9 5 5 5 4 3 a 9 6 9 1 7 a c 3 9 6 c 6 8 6 c 3 a a 9 6 c 6 a b c 4 3 9 1 6 9 5 5 2 a 9 5 5 5 2 c 3 9 6 d 3 c 5 6 d 2 c 3 c 5 5 7 a e 9 2 d 6 c 3 8 5 5 3 a 9 6 d 2 9 6 b 9 6 b a c 6 c 5 2 c 6 d 1 3 a 
a c 3 b 9 5 6 a c 3 a c 3 c 3 a c 5 5 3 c 3 b c 6 e a b 9 1 6 8 5 5 6 e c 3 a 9 5 6 a c 3 d 3 c 5 6 a 9 5 2 9 5 5 5 4 3 c 5 5 5 5 6 9 6 e 9 1 3 a c 5 3 a e a 9 5 6 a 9 2 c 3 a c 5 5 1 3 a d 1 5 6 c 2 
a 9 6 a c 1 7 a 9 6 a 9 4 7 a c 3 9 5 6 b a a 9 5 1 6 c 2 a b c 5 3 d 1 5 2 a e 9 3 a b c 5 2 d 5 1 6 a 9 6 8 5 3 d 5 4 5 1 5 5 5 5 2 9 5 6 a e c 5 3 e a 9 4 6 9 3 a a e 9 6 a 9 5 3 a a a 9 6 9 1 7 a 
a c 3 c 1 6 9 6 a b a c 5 5 6 d 2 c 5 3 a a 8 6 b c 5 3 a a 8 5 3 a 9 6 9 6 c 5 2 a c 2 d 3 a 9 5 6 9 6 a d 4 3 c 3 9 5 3 e 9 5 3 9 6 a 9 3 c 5 1 7 c 3 c 6 9 3 a c 6 8 5 6 9 6 a d 4 6 e c 6 9 6 c 5 6 
a b c 3 e 9 6 9 6 a a 9 3 9 1 3 c 5 3 a a a c 5 4 7 9 6 a a c 7 c 4 6 9 4 7 9 3 e 8 7 c 5 2 c 6 d 5 2 b c 5 3 e 9 2 a b c 3 a b a c 7 c 6 c 5 3 c 3 9 6 9 5 2 c 6 9 5 6 d 5 0 3 c 5 5 5 1 7 9 6 d 5 1 3 
8 6 9 2 9 6 9 2 9 2 a a a e a c 5 3 a a 8 6 9 5 5 3 c 3 a c 3 9 3 9 5 4 7 9 6 c 3 a 9 5 3 c 3 d 1 5 6 8 5 3 a 9 6 a c 2 b c 4 6 a 9 5 5 5 5 3 a b c 6 9 6 d 6 9 3 a d 1 5 3 a a 9 5 5 3 c 5 6 9 1 5 6 a 
e 9 6 a a d 6 a a c 6 a c 5 6 b 9 6 e a c 3 c 3 d 2 9 6 a b a a a c 7 9 3 a 9 3 a a c 3 8 7 c 3 c 3 9 6 b c 4 6 d 6 9 6 8 7 9 5 2 a 9 3 9 5 2 a 8 7 9 4 5 3 9 6 a c 5 6 9 6 a c 6 9 3 8 3 d 5 6 c 5 3 a 
9 6 d 6 a 9 5 6 a 9 1 6 9 5 5 2 c 5 3 a d 4 3 c 3 c 6 9 6 a a a a 9 3 a a a a e a 8 5 6 c 5 1 4 5 6 c 3 a 9 5 3 9 3 a d 4 3 a d 6 c 6 a c 3 e a a 9 6 9 3 8 6 b c 3 9 3 a d 4 3 9 6 a a c 5 5 5 5 5 6 a 
a 9 5 3 a a 9 5 6 e a b a b 9 6 9 3 a c 3 b a 9 6 9 3 a 9 2 a a a a a a c 6 c 3 a e 9 3 9 3 e 9 3 9 3 c 6 c 3 c 6 a c 5 3 a c 5 1 5 7 a b c 5 6 c 4 7 a a c 5 6 9 6 a a c 5 3 e a b a c 3 9 5 5 5 5 5 6 
c 4 7 c 4 6 c 5 5 5 6 c 4 6 c 5 6 c 4 5 6 c 4 6 d 6 c 4 6 e c 6 c 6 c 4 5 5 5 6 c 5 6 c 6 c 5 6 c 6 c 5 5 5 4 5 7 c 5 5 4 4 5 7 c 5 5 4 4 5 5 5 5 5 5 6 c 5 5 5 6 d 6 c 5 5 4 5 6 c 4 5 6 c 5 5 5 5 5 7 

Entry point: (10, 6)
Exit point: (1, 2)
Player's position: (10, 6)
Pathway----------------------
