9 1 3 9 5 5 5 5 3 
a e a a 9 5 5 7 a 
a f a a a f f f a 
a f c 4 0 5 7 f a 
a f f f a f f f a 
c 5 3 f a f d 5 2 
d 3 a f e f f f a 
9 6 a 9 3 d 1 5 2 
c 5 4 6 c 5 6 d 6 

Entry point: (2, 2)
Exit point: (1, 4)
Player's position: (2, 2)
