d 5 5 5 3 9 5 3 9 3 
9 5 1 7 a c 7 c 2 a 
a f a 9 6 f f f a a 
a f e c 1 5 7 f e a 
a f f f a f f f 9 2 
8 1 7 f a f d 5 2 e 
e c 3 f a f f f c 3 
9 5 4 7 a b 9 1 5 2 
8 3 9 5 6 c 6 a 9 6 
e c 4 5 5 5 5 6 c 7 

Entry point: (1, 1)
Exit point: (4, 4)
Player's position: (1, 1)
Pathway----------------------
