D 3 9 3 9 5 1 5 5 3 D 5 1 3 9 5 3 9 1 5 3 D 1 1 5 7 9 1 5 5 5 5 5 3 D 1 5 5 5 1 7 9 5 5 5 5 5 5 1 7 9 5 3 9 5 1 3 D 1 1 5 3 D 5 1 3 D 1 5 5 5 5 1 3 9 1 5 3 9 5 5 7 9 5 5 5 1 5 5 3 B 9 1 5 5 1 7 9 1 7 
B A E C 2 9 6 B 9 6 9 3 A A A B C 6 C 3 C 3 E 8 5 5 6 A D 5 5 5 3 C 3 C 5 3 B C 5 4 5 5 3 B 9 3 C 5 4 3 A A 9 6 C 3 E A 9 6 9 5 6 C 3 A D 5 3 9 6 A E A 9 6 A 9 5 5 6 9 3 9 2 9 3 A 8 6 A 9 3 E 9 6 C 3 
A C 5 3 E A D 0 6 9 6 C 6 E C 4 1 7 9 6 B C 3 C 5 7 9 6 9 5 5 5 2 B C 5 3 C 6 9 5 3 9 7 A A A A 9 3 D 2 C 6 A D 5 4 5 6 A 9 6 B 9 3 A C 5 5 2 C 3 C 5 2 C 5 2 A D 1 5 2 A A E A A A C 3 A A C 3 C 3 B A 
8 5 3 C 3 C 3 A D 0 5 5 3 9 5 5 6 9 6 D 4 1 6 9 3 9 6 D 4 5 3 B A C 1 7 C 3 9 6 9 6 C 1 6 A A C 6 C 3 E 9 3 C 5 1 3 9 3 C 6 B 8 6 A C 5 3 D 6 9 6 D 5 6 9 3 E C 3 C 7 A A C 5 6 A C 3 E A C 3 C 3 C 2 A 
8 3 E 9 6 9 6 C 3 A D 3 A A 9 3 B A 9 5 3 A 9 6 8 6 9 5 5 3 A A C 3 8 1 3 C 6 B C 5 3 C 3 A C 5 3 D 4 3 A C 5 3 A A A C 5 7 8 6 B 8 3 9 6 9 5 2 9 5 5 3 A C 1 7 C 5 5 6 C 5 3 B A D 4 3 C 3 A B C 3 A A 
E C 3 C 3 A B 9 6 C 5 6 C 2 A A A C 6 B A C 6 9 6 9 6 B 9 6 A C 3 A A A A 9 5 4 5 7 A B 8 6 9 3 C 5 3 C 6 B 9 6 A A A 9 5 3 A D 2 A A C 3 C 3 A A 9 3 C 6 B C 1 5 5 3 B 9 5 6 A A 9 3 C 5 6 C 2 B A A A 
9 5 2 B C 6 A A D 1 5 5 3 C 6 C 4 5 5 2 C 5 3 C 3 C 1 6 A 9 6 9 6 A E A C 6 9 5 3 9 6 8 6 9 6 C 5 5 6 9 5 6 A D 6 A A A B A A 9 2 A C 7 C 5 2 E C 6 A 9 5 4 3 C 5 3 C 2 A 9 5 2 C 6 C 5 5 1 3 A A A A A 
A D 4 4 3 9 4 6 9 6 9 3 C 5 5 3 9 7 9 6 9 5 6 D 4 7 A 9 6 8 3 C 5 4 5 6 9 5 6 B A C 3 A 9 6 9 3 D 5 3 8 5 5 6 9 5 6 A C 2 C 6 A E C 5 5 5 5 6 9 5 5 6 A 9 3 C 5 3 A D 6 A A D 4 5 5 5 5 3 A E C 2 A A A 
8 5 5 3 E C 3 9 6 9 6 C 5 3 9 6 8 5 6 B A 9 5 5 5 5 6 A D 6 A 9 5 3 9 5 6 9 5 2 A 9 6 E C 5 6 A 9 5 6 C 5 3 9 2 D 3 8 5 6 B 9 4 1 5 5 5 5 5 3 A 9 3 B C 6 A B 9 2 C 5 3 A 8 5 3 9 3 9 7 A C 5 5 6 C 6 A 
A D 3 C 5 5 6 A D 2 9 3 9 6 C 3 C 3 9 2 C 6 D 5 5 5 3 C 3 9 6 A B C 6 B 9 6 9 2 A A D 1 5 3 9 6 A 9 5 3 9 6 E A 9 2 C 3 D 4 6 9 6 D 5 5 5 5 2 C 6 A 8 5 3 C 2 A C 1 7 C 6 8 7 A A A C 3 C 5 3 D 1 3 9 6 
A 9 4 7 9 3 9 4 3 A E A C 5 5 6 9 6 E C 1 5 5 5 5 5 4 3 A C 5 2 C 5 5 4 0 7 A A A A 9 6 B C 6 9 4 6 B C 6 9 3 A A C 3 C 1 5 5 6 9 5 5 5 5 3 C 5 7 A A D 6 9 6 C 3 E 9 5 5 6 9 6 A C 5 4 3 9 6 9 2 E C 3 
A C 1 3 A C 6 9 6 A 9 4 5 5 5 7 A D 1 3 8 3 9 3 9 5 5 6 A 9 3 C 5 5 5 3 E 9 6 E C 6 A 9 4 1 7 A 9 5 0 5 5 6 C 6 A D 4 3 A 9 5 5 6 9 7 9 3 C 5 3 9 6 A 9 5 6 9 3 C 5 4 7 9 5 6 9 2 9 3 D 6 A 9 6 A 9 5 6 
C 3 E C 6 9 3 A B A A 9 5 5 5 5 6 9 6 A A C 6 A A 9 5 5 2 A C 3 D 5 5 4 3 8 3 9 1 5 6 A D 6 9 6 8 7 C 5 5 5 5 3 C 5 3 A A C 3 D 5 4 1 6 A 9 5 6 C 3 A A B 9 2 C 1 5 7 9 6 9 5 2 E A C 5 3 A A D 6 C 5 3 
B A 9 5 5 6 C 6 A A A C 5 5 3 D 5 2 B A E 9 3 A A C 3 9 6 A B A 9 5 5 3 A A A A A 9 7 8 5 3 C 3 A 9 5 5 5 3 9 6 9 3 A E A B A 9 5 3 A B A A 9 5 5 6 8 6 C 2 A B A 9 5 6 B C 3 C 5 6 9 3 A A 8 5 1 3 9 2 
A C 6 9 1 7 9 5 4 6 C 3 9 5 6 9 5 6 8 6 9 6 C 6 A B A C 3 C 2 C 6 9 7 A A E C 6 A 8 5 6 B C 3 A E C 3 9 5 6 A 9 6 A C 3 A A C 6 9 6 C 2 A C 6 9 1 7 C 5 3 A A A A C 3 9 6 9 6 B 9 5 6 C 2 A C 3 A A A A 
8 7 9 6 A 9 6 D 1 5 1 6 A 9 5 4 3 D 2 D 2 9 5 3 C 6 C 3 8 7 C 3 9 2 9 6 C 5 5 3 A C 5 5 4 3 C 6 9 3 A A D 5 4 4 7 C 3 A A 8 1 3 A 9 5 6 8 3 9 2 E 9 1 7 A E A A C 3 A 8 5 6 9 2 C 3 9 7 A A D 6 A A A E 
8 3 8 7 A C 5 3 C 3 C 5 6 A 9 3 C 3 C 3 A 8 7 C 5 1 3 A E 9 5 4 6 E C 5 5 1 3 A A 9 5 3 B C 3 9 6 C 6 C 5 5 1 5 5 5 6 8 6 E A A A E 9 3 E A A C 3 A C 5 6 9 6 A 9 6 A C 3 D 2 A B A C 1 6 A 9 5 6 A C 3 
E A A 9 0 7 9 6 B C 5 5 3 C 6 E 9 6 9 6 C 6 9 5 3 E A C 5 6 9 3 9 3 9 5 3 E A C 6 8 3 C 6 9 6 8 3 9 5 5 5 5 6 9 5 3 9 6 9 5 2 E C 3 A C 3 C 2 9 6 A 9 5 5 6 D 4 2 9 6 B A 9 6 A A C 3 E 9 6 A D 3 C 3 A 
9 6 A A A 9 6 9 0 5 5 7 C 5 5 5 6 B A 9 1 5 6 B A 9 4 3 B 9 6 C 6 A A D 4 5 6 B 9 6 C 5 3 A B A A A 9 5 5 5 5 6 B A 8 5 6 9 6 9 5 6 C 3 C 3 A C 3 C 2 9 5 5 5 3 E A 9 2 A A B A 8 3 A 9 6 9 4 3 C 3 A A 
A 9 6 A E A B A C 5 5 5 1 3 9 5 1 2 A E A 9 5 2 C 6 B A A A D 5 3 A A 9 3 9 5 2 A 9 5 5 6 A A A A E A D 1 3 9 5 2 A E 9 3 E 9 6 9 5 5 6 9 6 C 7 C 5 2 C 3 D 1 6 9 6 A E A A A C 6 A A A D 4 7 A 9 6 A A 
A C 3 C 3 A 8 6 D 1 7 9 6 A A B A E C 5 6 C 3 C 5 5 2 C 2 C 5 3 A A C 6 A A B A A A 9 5 5 6 A A C 3 C 5 6 C 6 B A A 9 6 C 3 A D 2 9 5 3 C 5 3 9 5 3 C 7 8 3 C 5 6 9 4 3 C 2 C 5 5 2 C 4 5 3 9 6 A 9 6 A 
8 7 C 3 C 6 C 5 5 2 9 6 D 6 C 2 C 5 5 5 5 1 6 D 1 7 C 3 A D 3 A A A 9 3 A C 2 C 6 A A 9 5 5 2 A B 8 5 5 5 3 B 8 6 C 6 9 1 6 C 3 C 6 9 6 9 3 C 6 B A 9 3 E 8 5 5 3 C 7 C 5 6 9 5 3 E 9 3 D 2 A 9 2 A 9 6 
8 1 7 C 3 9 5 5 3 A C 5 5 1 7 A D 1 5 5 3 C 5 3 8 5 5 6 C 3 A A C 4 6 C 2 D 4 1 7 C 2 A D 3 A A A C 3 D 5 4 6 A 9 1 5 6 E 9 3 A 9 5 6 D 6 8 3 B 8 6 A C 3 C 5 3 C 5 5 5 5 5 4 7 C 5 6 C 3 C 6 E 8 6 C 3 
A C 5 3 C 6 B 9 6 C 3 9 3 C 5 6 9 6 9 3 A 9 3 A 8 5 5 7 9 6 A C 3 9 3 B A 9 3 E 9 3 A C 5 2 A C 2 9 6 9 5 5 5 6 A E 9 5 3 A A C 6 D 1 5 3 A C 2 C 5 6 B C 3 9 6 D 5 5 5 5 3 9 5 5 5 3 9 6 9 5 3 A 9 5 6 
C 3 9 4 3 9 2 A 9 3 C 6 A D 1 3 A B A C 6 A A A A 9 3 9 6 9 0 3 C 6 A A A A C 5 6 A C 3 9 6 C 5 6 A 9 6 B 9 5 3 C 3 A 9 2 A 8 5 5 5 2 D 4 6 B A 9 5 5 6 9 6 A 9 5 5 5 5 5 2 C 3 9 5 4 6 9 6 9 6 E C 5 3 
9 6 A D 4 6 A A A C 5 5 6 9 6 C 6 8 6 B 9 6 A A A A A A D 6 A E 9 5 6 C 6 A 9 5 5 6 9 6 A 9 3 9 3 C 2 D 2 A D 2 9 2 A A E A C 5 3 B A 9 3 D 0 4 6 9 5 3 A B 8 6 9 3 9 5 5 4 7 A C 5 3 9 6 B C 5 5 5 3 A 
A 9 6 9 5 3 E A C 5 3 9 5 2 9 3 9 6 9 2 C 3 C 6 E A C 4 3 9 2 9 6 9 5 5 5 2 C 5 3 B A D 4 6 E A C 3 C 5 2 C 3 C 6 E A C 3 A B 9 6 8 6 A C 3 C 7 9 4 7 A A C 2 9 6 A C 5 5 7 9 6 9 7 A C 3 8 5 7 9 5 6 A 
A C 5 4 7 C 3 A 9 5 6 C 3 A A E C 1 6 C 7 C 3 9 3 A 9 3 C 6 E C 5 2 9 5 3 C 1 7 A A A 9 5 3 9 6 D 4 5 3 8 7 A 9 5 5 6 9 6 A A C 3 C 7 C 3 A 9 5 6 B 9 6 C 3 E A B C 1 5 5 5 6 B 8 5 6 9 6 C 5 3 C 5 5 2 
8 7 9 5 3 9 2 A A D 1 3 E A 8 5 5 6 9 3 9 3 A A C 6 A C 5 3 9 5 3 E C 3 A D 6 9 6 A C 6 B A C 5 5 3 B A A 9 6 C 5 3 B C 5 4 4 7 C 5 1 3 A C 6 9 1 6 C 3 9 4 5 6 C 5 2 9 3 9 1 6 A 9 7 A 9 3 9 2 9 5 5 6 
A 9 6 B A A A A C 5 6 C 1 6 C 5 5 3 A A A C 6 C 1 7 A 9 7 A A D 4 5 5 6 C 5 5 6 9 6 9 5 2 C 3 9 5 6 A A A C 1 5 7 8 4 5 7 9 5 3 9 3 A A C 5 3 E C 1 3 A 8 7 9 5 5 3 E A A A C 3 A A 9 6 A C 6 A C 5 3 B 
A C 3 C 4 6 A C 3 9 5 3 E 9 3 D 5 6 A A C 1 5 5 6 9 6 A 9 6 A 9 5 5 3 D 3 9 1 3 A 9 6 9 4 3 A C 3 B 8 6 C 3 C 5 3 A 9 5 3 A D 4 6 A A C 3 9 6 9 5 6 E C 6 9 6 D 3 C 5 6 A C 3 C 4 6 A 9 2 9 3 C 5 3 C 2 
C 3 C 3 9 3 C 7 A A 9 6 9 6 C 5 3 9 6 C 3 A B 9 5 6 D 0 6 D 4 2 B 9 6 9 6 A A C 6 8 7 A 9 6 C 5 6 8 6 D 3 A 9 5 6 A A D 2 8 3 B 9 6 C 7 C 4 5 6 9 5 5 5 5 6 9 5 2 9 5 7 C 3 C 7 9 5 6 A E A A D 5 6 9 6 
9 6 B C 6 C 5 3 A A A 9 6 D 1 3 C 6 B 9 6 A A C 5 5 3 A D 1 3 C 2 C 3 C 5 2 C 5 5 6 9 6 A 9 5 3 9 6 9 3 C 6 C 5 5 6 C 3 A E A 8 6 D 1 5 5 5 5 5 6 9 3 9 5 5 2 9 6 8 5 5 3 C 5 5 6 9 3 8 5 6 A 9 5 3 C 3 
C 5 4 3 9 1 7 A A A C 6 9 5 6 A D 3 8 6 9 6 8 1 5 7 A 8 5 6 C 3 C 7 8 5 3 C 1 7 9 1 6 D 4 6 D 6 C 5 6 A 9 5 5 5 5 5 5 6 C 5 6 A 9 5 6 9 5 1 5 3 9 6 C 6 9 5 6 C 3 C 7 9 6 9 3 9 5 6 C 6 D 3 C 6 B C 5 6 
9 5 3 C 6 A 9 6 C 6 9 5 4 3 9 6 9 6 A B A D 2 E 9 5 6 A 9 5 3 C 5 3 E 9 6 9 6 9 6 E 9 5 3 9 5 5 1 5 3 C 6 D 1 3 9 5 7 9 1 5 7 C 6 9 5 6 9 6 D 2 C 7 9 5 6 9 3 9 6 9 5 2 9 6 A A D 5 5 5 1 4 3 9 4 3 9 7 
C 7 A 9 5 6 C 5 1 7 C 3 9 6 C 5 2 9 6 A C 3 8 3 C 5 3 E A B C 3 B C 5 6 B C 3 C 5 5 4 7 C 2 D 3 C 3 C 3 9 1 6 C 6 9 3 A C 3 9 1 3 A 9 3 C 5 3 C 5 5 6 9 1 6 E A 9 2 D 6 A B A C 5 5 5 5 6 B C 6 B A C 3 
9 5 2 A D 1 5 3 C 5 3 A C 5 5 3 E C 3 C 5 2 E 8 5 3 C 5 6 C 3 A A 9 5 5 0 7 A D 3 9 5 5 3 C 3 C 3 C 3 E A C 5 3 9 6 C 6 B A A A A A A C 1 3 C 3 D 1 3 A A 9 5 6 A C 5 3 C 2 C 1 3 9 5 5 1 4 3 9 6 C 3 A 
C 3 E C 3 C 3 C 3 B C 6 9 5 5 2 9 5 6 9 3 C 3 E 9 4 5 5 3 9 2 A A C 5 3 C 5 4 5 6 C 3 B C 3 C 5 2 B C 5 4 7 9 2 A D 5 1 2 A A A A A E 9 6 C 7 A 9 6 C 6 E A 9 3 A B 9 2 B C 3 A E A 9 3 C 3 A C 5 3 A A 
9 6 9 5 6 9 6 B C 2 D 3 C 5 3 E C 5 5 6 A B A 9 6 D 1 7 C 6 A A 8 5 3 C 3 B 9 5 5 5 6 A 9 6 9 7 A 8 7 9 3 9 2 E A 9 5 6 A C 6 A E C 3 A 9 5 3 A C 1 5 5 5 4 6 A C 6 A C 2 B A C 5 6 A C 3 A C 5 3 A C 2 
C 3 C 3 D 4 3 C 5 4 3 C 1 7 C 1 1 5 7 9 6 A A C 5 3 A 9 5 5 6 A C 7 C 3 A A A 9 5 5 5 2 C 3 8 5 4 6 9 6 8 6 E 9 6 8 3 9 6 9 7 C 5 5 6 C 4 7 A C 3 A 9 5 5 5 3 C 5 3 A 9 6 A C 5 3 D 2 9 2 C 5 3 C 4 7 A 
9 4 7 A 9 3 C 5 5 3 A 9 2 9 5 6 A 9 3 C 3 8 6 9 5 6 8 6 9 5 5 6 9 1 5 6 C 2 A C 7 9 3 A 9 6 C 3 B 9 6 D 6 9 5 6 D 6 A C 5 6 9 5 5 5 1 5 5 5 4 3 A A A D 3 9 6 B 9 6 A 8 5 4 5 7 C 3 E A C 3 B A 9 5 3 A 
A 9 5 6 A C 5 3 9 6 A A A A D 5 6 A 8 7 A C 5 6 B 9 4 7 C 3 9 3 A A 9 1 7 A A 9 3 A 8 6 C 3 B C 2 A 9 5 5 6 D 1 5 3 C 5 5 5 6 9 5 5 6 9 5 5 5 2 A E C 3 A C 3 8 4 5 6 E 9 5 5 1 7 C 5 6 B A A C 6 9 6 A 
A C 5 5 6 B 9 6 8 3 C 6 A C 5 5 5 6 A 9 6 B 9 1 2 A B 9 5 6 A C 6 A A C 5 6 C 2 C 6 E 9 1 6 C 1 6 C 4 5 5 5 5 6 D 4 5 5 5 5 3 C 3 D 1 4 7 9 3 E C 5 5 4 6 9 6 C 7 9 5 5 6 D 3 C 5 5 5 1 6 A 8 1 7 C 5 6 
8 1 5 7 9 4 6 9 6 A 9 3 A 9 5 3 9 3 A A 9 4 6 A E 8 6 C 1 3 8 3 D 6 A D 5 3 9 6 F F F A E 9 3 C 5 7 9 3 F F F F F F F F F B C 3 C 3 A 9 3 A C 5 5 3 9 3 9 6 9 5 3 A B 9 5 1 2 D 1 1 3 C 3 A E C 5 5 1 3 
A E 9 5 6 9 3 A B A E C 2 C 3 A A A C 6 C 3 B C 5 6 9 3 E A A C 5 5 4 5 5 6 A B F F F 8 5 6 C 5 5 5 6 A F F F F F F F F F 8 5 6 9 6 E A A C 5 3 B A A A A 9 6 B C 6 C 4 7 A C 3 E A E 9 2 C 3 9 3 9 6 E 
8 3 A D 1 6 C 4 6 A 9 3 C 3 A E A C 1 1 7 C 2 9 5 3 A C 3 A 8 5 7 9 5 5 5 5 6 A F F F A 9 3 D 1 5 3 9 2 F F F F F F F F F C 3 9 4 5 5 6 A 9 5 6 A A A A C 6 9 0 3 9 5 5 5 6 B C 5 2 9 6 A B C 6 A 8 5 3 
E A C 3 C 3 D 3 9 6 A C 3 C 6 9 4 7 A E 9 5 6 A D 6 C 3 C 6 A 9 5 6 9 5 3 D 1 2 F F F C 6 A 9 6 9 6 A A D 1 5 3 D 3 F F F 9 6 A 9 3 9 7 A A D 5 2 A A C 5 5 6 A C 6 9 5 5 5 2 9 5 6 A D 4 6 9 5 6 E 9 2 
9 2 9 6 B A 9 2 C 5 6 B C 5 3 A 9 3 A 9 6 9 3 C 5 5 3 C 3 D 6 C 5 3 C 3 C 5 6 A F F F 9 3 C 6 B A B A C 3 A B C 3 A F F F A D 4 6 A C 3 A C 5 3 A C 6 D 5 3 9 6 D 5 2 9 3 9 6 A 9 3 A 9 5 5 6 9 5 5 6 A 
A A A D 0 4 6 C 5 3 9 4 5 3 C 6 A A A C 5 6 C 3 9 5 2 B A 9 5 5 5 6 9 6 9 5 7 A F F F E C 5 5 4 4 2 A D 4 6 C 5 4 6 F F F C 3 D 3 C 3 A 8 3 B A 8 3 9 5 3 A C 5 5 3 A E A C 3 A E A C 6 B 9 1 6 9 5 7 A 
A E C 3 A 9 5 5 3 A C 3 B C 3 9 6 A 8 5 1 5 7 A C 3 C 6 8 6 9 5 3 D 2 B 8 3 9 6 F F F F F F F F F A C 3 F F F F F F F F F B C 3 C 1 6 A A C 2 C 6 C 6 9 6 8 5 3 9 6 A 9 4 3 A A 9 2 D 5 4 6 A 9 6 9 5 6 
8 5 3 A E A 9 7 A C 5 6 8 3 A C 3 C 6 D 6 9 3 C 5 2 9 3 C 5 6 9 6 9 6 A A C 6 B F F F F F F F F F E 9 2 F F F F F F F F F 8 7 C 3 A 9 2 A 9 6 9 5 1 3 A D 6 9 6 C 3 C 6 9 6 C 6 A A 9 5 3 9 6 C 5 4 5 7 
C 7 A C 3 A 8 3 C 3 9 1 6 A A 9 2 9 3 9 5 6 8 3 9 6 A A D 5 1 6 9 6 9 2 C 3 9 2 F F F F F F F F F 9 6 A F F F F F F F F F 8 5 5 6 C 6 A A A D 4 7 A E C 5 5 2 9 5 6 D 3 A 9 5 1 6 A C 3 A C 5 3 9 5 5 3 
9 5 4 3 C 6 E A 9 6 E A 9 6 A A E A A A 9 3 A A A 9 6 C 5 3 C 5 6 B A C 5 6 A 8 5 5 3 9 5 3 F F F A D 6 F F F 9 5 3 D 3 9 6 D 1 3 9 3 A A C 5 5 3 C 5 5 1 3 A C 3 9 1 6 A A 9 6 B A 9 6 C 3 9 6 C 5 3 A 
8 5 3 C 5 5 1 6 A 9 5 6 C 7 A C 5 6 C 6 A C 6 A A A 9 3 B C 3 9 5 2 C 3 9 3 A C 3 D 4 6 D 2 F F F C 5 3 F F F A D 4 5 6 C 5 3 A A A E A C 3 9 3 A 9 5 3 A A A B A E A 9 6 E A 9 2 C 6 D 3 8 6 9 5 3 A A 
C 3 C 5 5 3 E 9 6 8 3 9 3 9 6 9 3 D 1 3 C 3 D 2 A C 6 A 8 5 6 C 7 C 5 2 E A C 3 C 5 5 5 3 E F F F B 9 6 F F F C 5 5 5 5 5 3 C 6 A 8 5 4 7 A A C 4 6 D 0 6 E C 2 C 3 C 4 5 5 6 A E 9 5 1 6 A 9 6 B C 6 A 
9 6 D 1 3 C 5 6 9 6 A A C 6 D 2 C 5 6 A B C 3 E A 9 5 6 A 9 5 1 3 9 3 C 3 8 5 4 5 3 D 3 C 3 F F F A C 3 F F F F F F F F F 8 7 9 6 8 7 9 5 2 C 7 9 5 3 E 9 5 5 6 B C 5 5 3 B 9 4 3 A B C 5 6 A 9 4 3 B A 
C 5 5 6 A 9 5 3 A B A A 9 5 5 6 B 9 3 C 4 3 C 3 A C 3 9 6 A B A A A A D 2 E 9 3 D 4 5 2 9 6 F F F 8 7 A F F F F F F F F F 8 5 6 B A 9 6 D 6 9 5 6 9 6 9 6 D 1 5 4 7 9 3 A C 2 B A C 2 B 9 3 C 6 9 4 6 A 
9 5 3 B C 6 9 6 C 2 A A A 9 5 3 C 6 C 3 9 4 7 C 6 9 6 A B C 2 A C 6 C 3 C 5 6 C 3 9 3 E C 3 F F F A 9 6 F F F F F F F F F C 3 9 6 A C 3 9 3 A 9 7 C 3 C 5 3 8 5 5 3 A A C 3 A A A 9 6 C 6 A 9 5 6 9 5 2 
C 3 8 4 5 7 A B 9 6 C 2 A A 9 6 9 5 3 A C 3 9 5 5 6 9 6 A 9 6 A 9 5 3 C 3 9 5 3 A A C 5 3 C 5 1 3 A C 3 9 5 5 3 9 5 3 9 5 5 6 8 5 6 B A A C 6 A 9 3 C 1 3 A C 7 9 6 A A 9 6 C 2 C 4 5 5 1 6 C 3 B A B A 
9 6 E 9 5 3 A C 6 9 3 C 6 A A 9 6 B A 8 3 A C 5 3 9 6 B 8 6 9 6 C 7 8 5 6 A D 6 C 6 D 3 C 5 3 A C 2 9 2 A 9 7 C 4 7 A C 3 D 3 C 5 3 A C 6 D 1 6 A C 5 6 E C 5 3 A 9 6 A A D 5 4 5 3 9 3 E 9 3 A A A C 6 
A 9 3 C 3 A C 5 3 A A D 1 2 A C 3 A A A E A 9 3 A A D 4 4 3 C 5 1 3 C 3 9 4 5 5 1 5 1 6 9 5 6 C 3 E A E C 2 9 5 5 3 A B C 3 C 1 3 A 8 3 D 1 2 9 2 9 5 5 5 5 3 A A A 9 2 C 5 5 5 3 E A C 3 A C 6 A C 5 3 
A A 8 7 A C 5 3 A A C 3 E A C 5 6 A A A 9 6 E A A C 3 9 3 A 9 3 E A 9 6 E 9 5 3 C 3 A 9 6 D 1 3 8 3 C 5 5 6 C 3 D 4 6 C 3 A 9 6 E A A C 3 A A A E C 3 9 5 5 2 A C 6 A A 9 3 D 3 C 3 A B A A 9 5 4 3 9 2 
8 6 C 5 6 9 1 6 C 6 B C 3 C 3 B 9 2 C 2 A D 1 2 C 3 A A A E A C 5 6 A D 1 6 B A B A C 4 5 5 6 A E C 5 1 5 5 7 8 5 5 5 3 A A 8 5 3 C 6 9 6 A E C 1 3 A C 3 9 6 C 5 5 6 C 6 C 3 A 9 6 C 2 C 6 A 9 3 E A A 
E 9 5 5 5 2 E 9 1 7 8 5 6 9 6 8 6 C 5 2 C 3 A A B A C 6 A 9 6 9 5 7 C 3 C 3 A A A C 3 9 3 D 5 4 5 3 9 6 9 5 3 A D 1 3 A 8 6 A 9 4 5 7 8 5 6 9 5 6 A C 3 A C 3 9 1 5 5 5 3 B C 2 C 5 3 A 9 5 2 A C 5 6 A 
9 6 D 5 5 6 9 6 C 5 6 9 5 2 9 4 7 9 3 E 9 6 A 8 6 A 9 3 C 6 9 2 9 5 3 C 5 6 8 6 C 5 2 A A 9 5 3 B A C 3 A 9 6 A 9 6 E A A 9 6 C 5 5 3 A 9 5 2 9 3 C 7 A C 3 E A C 3 D 1 6 A 9 6 9 3 C 4 6 D 6 C 3 D 5 6 
A 9 5 5 5 3 A 9 5 1 7 A B A E 9 3 A C 3 C 3 A E 9 6 A 8 3 B A C 6 B 8 3 D 3 A D 1 3 A A C 6 B A A C 5 2 A C 3 C 6 9 5 6 A C 3 D 1 7 A A A D 6 A C 5 3 A 9 6 9 6 B C 3 A 9 2 A 9 6 8 5 7 9 3 9 3 C 3 9 3 
A A 9 3 B A A C 3 C 5 4 2 C 5 2 C 6 B 8 7 C 2 9 6 9 6 A C 6 C 5 5 2 A C 5 6 C 3 A A E A 9 3 8 6 C 5 3 A C 3 C 3 9 6 D 3 C 3 A 9 2 9 6 A C 5 3 A 9 3 C 6 C 5 6 D 4 3 A A E A A C 3 E 9 5 6 A A C 5 6 A A 
A C 6 A A A C 3 C 7 9 3 E 9 3 C 1 5 6 8 5 5 6 A 9 6 9 2 9 5 5 5 5 6 C 5 5 5 3 C 6 C 5 6 A A C 5 5 3 8 6 B C 3 C 6 D 1 2 B A C 6 E C 5 6 9 3 A A E 8 5 5 1 3 9 5 3 A A 8 5 6 C 3 C 3 C 3 9 6 A 9 3 9 6 A 
8 5 3 C 2 C 5 6 9 5 6 C 5 6 C 3 E 9 3 C 5 7 9 6 8 7 A E A D 5 5 5 1 3 9 5 3 A 9 3 9 3 9 6 C 5 5 3 A 8 5 6 9 6 9 5 5 6 A A C 5 5 5 5 5 5 6 A A C 3 C 5 7 A A A B C 2 A E 9 1 3 C 5 2 B A C 3 C 2 A 8 7 A 
A B C 3 A 9 3 9 6 9 5 5 5 3 9 6 9 6 C 3 9 5 6 D 6 9 2 9 6 9 3 9 3 A C 6 9 6 C 6 A A A A 9 5 7 9 2 A E 9 3 C 3 A 9 5 3 A C 5 5 1 5 3 9 7 9 6 8 5 4 5 5 5 6 C 6 8 5 6 C 5 6 A E 9 3 C 2 C 3 C 3 E C 6 9 6 
C 0 7 A C 6 C 6 9 2 9 3 D 6 A 9 4 3 9 6 C 5 5 5 3 A A A 9 2 A A A C 5 3 A 9 3 B A A A C 2 9 5 6 E C 5 6 A 9 6 A C 3 A A 9 3 9 6 9 6 A 9 6 B C 3 9 5 5 3 9 3 D 0 5 7 9 5 3 C 5 2 A 9 6 B C 3 C 5 5 3 8 3 
9 6 9 4 3 9 7 9 6 C 6 C 5 5 6 C 3 A A D 1 5 5 3 A A A A E A C 6 C 5 5 6 C 6 A A C 6 C 5 6 C 5 5 5 5 1 7 C 6 9 4 3 E A C 6 C 6 9 6 9 6 A 9 2 9 6 C 3 D 4 6 C 3 E 9 3 C 3 A 9 3 E A A D 0 7 C 3 9 3 A E A 
C 7 A D 4 6 9 6 9 5 5 5 3 9 5 5 6 A 8 5 6 D 5 4 6 A E C 3 A D 5 5 5 1 1 5 7 C 4 5 3 9 3 D 1 3 D 5 3 C 1 5 3 A B C 3 8 5 3 9 5 6 D 2 9 6 E C 4 5 7 C 3 D 5 5 4 5 2 C 5 6 C 6 C 3 A C 3 8 1 7 A A C 6 9 2 
9 5 6 9 3 9 6 9 6 B 9 3 C 4 3 9 5 2 E 9 3 9 5 3 9 4 5 5 0 6 9 3 9 3 E C 5 1 5 5 5 4 6 C 5 6 C 5 5 4 3 A B A A A 9 6 A B A A 9 1 5 2 A 9 5 5 5 5 5 3 8 5 3 9 3 D 6 9 5 3 D 1 5 6 C 1 6 E C 3 A A D 1 6 A 
8 3 9 6 C 6 B A 9 2 A A 9 3 E A D 2 9 6 C 6 9 6 C 7 9 3 E 9 6 A A C 5 5 3 C 7 9 3 9 5 3 9 5 5 1 5 7 A A C 6 C 2 C 3 C 6 A A A C 3 E C 6 B 9 1 7 9 6 A B C 6 C 5 3 8 7 C 3 C 3 9 3 C 5 5 5 2 A C 5 6 D 6 
E A C 5 3 9 2 A E A A C 6 C 3 8 3 E A B 9 3 8 3 9 5 6 C 5 4 3 A C 3 9 7 A 9 3 A A 8 3 A C 5 3 C 5 5 6 C 5 5 3 A B C 5 3 A A E 9 2 9 3 9 4 6 C 5 6 D 4 6 9 5 5 3 C 6 9 3 C 3 A A C 3 9 3 D 6 C 5 3 9 5 3 
9 2 D 3 A E C 0 5 6 8 5 5 3 A E C 5 4 6 A A A C 6 9 5 7 9 3 E C 1 6 A 9 2 A A A A E A C 1 7 C 5 5 3 9 7 9 3 C 2 A 9 5 6 A C 5 6 A A A C 3 B 9 5 5 1 5 3 A B 9 6 9 5 6 C 5 6 A A B C 6 C 5 5 5 3 8 6 9 2 
A C 5 6 C 5 3 E 9 3 C 3 B A C 5 3 9 5 5 6 A A 9 5 2 9 5 2 C 5 3 8 5 6 A E A C 6 C 3 C 3 E 9 1 5 7 A A 9 6 C 3 A A A 9 5 4 7 9 5 6 A C 5 6 C 4 3 9 6 9 6 A A A 9 6 D 5 1 5 7 C 6 8 5 5 3 9 5 5 6 E 9 6 A 
8 5 3 9 5 3 C 5 6 C 3 C 6 A 9 7 A A 9 3 9 6 C 6 9 6 A D 6 9 3 A E 9 3 A 9 6 B 9 5 6 9 2 9 6 A 9 3 C 2 A 9 5 6 C 6 A C 5 3 9 4 7 9 6 9 5 5 3 9 6 C 3 C 3 A A C 6 9 1 5 6 9 1 3 B C 3 B C 6 D 5 1 3 A D 6 
C 3 A C 3 8 5 5 5 7 C 5 5 6 C 3 A A A A C 5 5 3 C 3 C 5 3 A A A 9 6 A C 4 1 6 C 5 3 A E A B C 6 C 5 6 A A 9 3 9 5 6 9 5 6 A 9 5 6 B 8 3 B A E 9 5 6 B A A 8 1 5 6 E 9 3 A A C 2 9 6 8 3 9 5 5 6 A C 5 3 
D 6 C 3 A C 5 3 9 5 5 1 5 5 3 A C 6 A C 5 5 5 6 B 8 5 7 C 6 A A A B C 5 3 E 9 3 9 6 8 5 4 4 5 1 7 9 3 A C 6 C 6 D 1 2 9 5 6 A 9 5 6 A A C 4 5 6 9 7 8 6 A E 8 5 5 5 6 C 6 C 3 E C 5 6 A A 9 7 9 6 9 3 A 
9 5 5 2 A D 3 C 6 D 3 C 5 3 C 2 B 9 6 D 5 5 1 3 8 6 9 5 5 5 6 C 6 A 9 3 C 3 A A A D 4 7 9 3 D 2 9 6 C 6 9 5 5 5 3 A C 6 B 9 6 C 3 9 6 C 5 1 5 3 8 5 6 D 4 3 C 3 9 3 9 5 5 7 A 9 1 5 7 A A C 5 4 5 6 C 2 
A D 5 6 C 3 C 1 3 9 4 3 9 6 9 6 A A 9 5 5 5 6 E A B C 5 5 5 5 5 3 A A C 3 A A C 2 9 5 5 6 C 3 E C 1 5 3 C 5 3 9 6 C 5 3 A A 9 5 6 8 7 9 3 C 7 A C 5 3 9 5 6 B C 6 A A 9 5 3 C 6 C 5 5 6 A 9 5 5 3 D 5 6 
8 5 5 5 3 C 5 6 A C 3 A C 3 C 5 6 A C 1 3 9 5 3 C 4 3 9 3 B 9 3 A 8 6 B A A 8 3 E C 3 9 5 7 A 9 3 C 7 C 3 9 6 C 5 3 B C 2 A A 9 5 6 9 6 C 5 3 C 3 B A A D 1 2 B 9 6 C 4 3 8 3 D 1 5 5 1 6 A 9 7 A 9 5 3 
C 5 5 3 C 1 5 7 A 9 6 A B C 3 9 3 C 3 A C 6 B C 5 5 4 6 C 6 A C 6 C 5 2 C 6 A C 5 3 A C 1 3 C 6 A 9 3 9 6 A 9 3 B A 8 5 6 A C 6 9 5 6 9 5 5 6 9 6 8 6 C 3 A C 2 A 9 3 D 6 A C 3 C 7 9 6 9 6 8 3 C 6 9 2 
B 9 3 A B C 5 5 4 6 D 0 6 9 2 A C 3 A C 5 5 4 7 9 5 5 5 5 3 A B 9 5 3 C 5 3 E 9 5 6 C 3 E A 9 5 6 A A C 3 C 6 C 2 A C 5 7 C 5 5 6 B 9 6 B 9 5 2 B C 5 5 6 A 9 6 C 6 C 5 5 6 B C 3 9 6 9 6 D 6 A 9 5 6 E 
C 6 C 4 4 5 7 9 3 9 3 E 9 6 A A B A A 9 5 5 5 3 A B 9 5 5 4 6 A A B C 5 3 8 5 6 9 1 7 A 9 6 C 3 9 6 C 5 4 5 7 9 6 C 3 9 5 5 1 7 9 4 6 B 8 6 B A C 5 1 1 5 6 A B 9 5 3 9 1 5 4 7 A C 5 4 5 5 3 A C 5 5 3 
9 5 3 9 5 5 5 6 C 6 C 5 2 D 6 C 2 C 6 C 5 3 B A A C 6 9 3 B 9 4 6 C 1 3 C 6 9 3 A C 5 6 C 1 7 A C 5 1 5 3 9 5 6 9 3 C 6 9 3 C 3 C 5 3 A A D 2 C 5 3 A A 9 3 A C 6 9 2 A C 5 5 3 A 9 5 5 5 3 C 4 3 B 9 6 
A B A 8 3 D 1 5 3 9 3 9 6 9 3 9 6 D 5 1 5 6 8 4 6 9 5 6 A A C 5 5 3 E C 5 3 A C 6 9 3 9 3 A 9 6 9 3 C 7 C 4 5 5 6 A B 9 6 C 5 2 D 3 A C 4 3 8 7 9 6 A A A A C 5 1 6 E A 9 3 9 2 A 8 3 D 3 A 9 3 A A C 3 
A A A E 8 3 C 3 A A C 6 9 6 C 6 9 1 5 6 9 3 A B 9 6 D 3 A C 5 5 5 2 9 5 5 6 A 9 5 6 C 6 C 2 C 3 A A 9 5 5 3 9 7 9 4 6 C 5 3 D 4 5 2 C 5 3 A A 9 6 9 2 E A A 9 5 6 9 3 A A A A E A E C 3 8 6 E C 2 C 3 A 
A C 4 3 E A 9 6 C 6 9 3 A D 5 5 2 A 9 3 E C 4 2 A 9 1 6 C 5 3 9 3 C 2 9 5 5 6 8 3 9 3 9 5 4 7 C 6 C 6 9 5 6 C 3 A 9 3 9 5 6 9 5 3 C 3 B A C 2 A 9 6 E 9 6 A C 1 7 A C 6 E A C 5 6 9 5 6 C 5 5 3 C 5 2 A 
8 3 9 4 5 6 E 9 5 5 6 A C 3 9 3 A E A C 5 3 9 6 A E 8 5 1 7 A A C 3 E C 3 D 5 6 A E C 4 5 7 9 3 9 5 3 8 5 5 3 C 2 A C 2 9 5 6 B A 9 6 A C 3 E A 8 3 9 6 B A 9 6 9 6 9 5 5 2 9 3 9 4 5 5 3 9 5 6 9 5 6 A 
A A C 7 9 5 5 6 D 1 7 C 5 6 A A A 9 6 9 3 A C 3 C 3 E 9 2 9 6 C 3 C 5 5 4 5 5 3 C 5 1 3 9 5 6 C 6 B A C 5 3 C 3 E A B A A 9 3 A A C 5 4 7 C 5 6 A A A 9 2 A C 7 A 9 4 3 B 8 6 E A B 9 3 A C 5 3 A D 3 A 
A C 5 3 C 3 D 1 3 A 9 1 5 5 2 C 6 C 3 A A A D 4 3 A 9 2 E C 5 5 2 9 5 5 5 5 3 C 5 3 A A C 3 9 7 9 2 C 3 9 6 B A 9 2 C 6 C 6 A A C 5 5 5 1 3 B 9 6 C 6 A A C 3 9 6 C 3 A C 6 9 5 6 C 6 A C 3 B A C 5 2 A 
A 9 7 C 3 C 5 6 A A A C 5 3 A 9 5 5 6 A A C 5 3 A C 6 A 9 5 5 3 A C 3 9 5 7 C 3 9 6 A C 3 A C 1 6 A 9 6 C 1 6 A A A 9 1 7 9 6 8 5 3 9 3 A C 2 A D 1 3 E 8 7 C 6 9 3 A C 5 5 4 5 5 3 9 2 9 6 A C 5 3 E A 
A A 9 5 0 7 9 5 6 8 4 5 7 A E A 9 1 5 6 A 9 3 A 8 5 7 A C 5 3 A A B A C 1 1 7 A A D 4 7 A C 3 C 3 A C 3 D 6 9 6 A A A C 5 6 B 8 3 C 6 A A 9 6 C 5 6 C 3 C 1 3 D 2 E A 9 5 3 9 1 7 A A E A B 8 5 3 A 9 6 
8 6 A 9 6 9 6 B 9 6 9 5 3 8 3 A E C 3 B 8 6 E A E 9 5 6 9 5 6 A 8 6 C 3 A A 9 6 C 5 5 3 8 3 A D 2 C 3 C 3 9 6 9 2 E C 5 3 D 4 6 C 1 3 E A C 7 9 5 1 7 C 5 6 C 3 C 5 6 A B A A E 9 4 6 9 6 8 6 B C 6 C 3 
A 9 6 8 7 C 3 8 6 9 6 B A A C 4 5 5 6 8 6 9 3 C 5 4 5 7 A 9 5 6 A 9 5 6 A A C 3 9 3 D 4 6 E C 3 E 9 0 7 A 8 3 A C 5 1 3 A 9 5 5 3 E C 3 C 5 5 4 7 C 1 5 5 7 9 6 9 5 5 6 A A 8 5 6 9 3 A B A 9 4 5 5 1 2 
A A D 6 9 3 A E 9 6 9 2 A E 9 3 9 3 D 6 9 6 C 5 3 9 3 9 6 A 9 3 E C 3 9 6 C 3 A A A 9 5 5 5 5 6 9 6 E 9 6 E A C 3 B A E A A 9 7 A 9 3 8 5 5 5 3 9 5 6 9 5 3 A 9 6 9 5 3 8 6 E 9 5 6 C 6 8 6 C 5 5 7 A A 
E C 5 5 6 C 4 5 6 D 6 C 4 5 6 C 6 C 5 5 6 D 5 5 4 6 C 6 D 4 6 C 5 5 6 C 5 7 C 4 6 C 6 D 5 5 5 5 4 5 5 4 5 5 6 D 4 6 C 5 4 6 C 5 4 6 C 6 D 5 5 6 C 5 5 4 7 C 4 6 D 4 7 C 4 5 5 6 D 5 5 5 4 5 5 5 5 5 6 E 

1, 1
10, 10
ESSEESESWSESENNENWNNENEEESWSWSSESWSSWWSESWWWNWWWSSSSESSENEEENESENNENWNNENENEEESEEESWSESWWWNENWWNWSWS
Original Pathway----------------------
(1, 1) | (2, 1) | (2, 2) | (2, 3) | (3, 3) | (4, 3) | (4, 4) | (5, 4) | (5, 5) | (4, 5) | (4, 6) | (5, 6) | (5, 7) | (6, 7) | (6, 6) | (6, 5) | (7, 5) | (7, 4) | (6, 4) | (6, 3) | (6, 2) | (7, 2) | (7, 1) | (8, 1) | (9, 1) | (10, 1) | (10, 2) | (9, 2) | (9, 3) | (8, 3) | (8, 4) | (8, 5) | (9, 5) | (9, 6) | (8, 6) | (8, 7) | (8, 8) | (7, 8) | (6, 8) | (6, 9) | (7, 9) | (7, 10) | (6, 10) | (5, 10) | (4, 10) | (4, 9) | (3, 9) | (2, 9) | (1, 9) | (1, 10) | (1, 11) | (1, 12) | (1, 13) | (2, 13) | (2, 14) | (2, 15) | (3, 15) | (3, 14) | (4, 14) | (5, 14) | (6, 14) | (6, 13) | (7, 13) | (7, 14) | (8, 14) | (8, 13) | (8, 12) | (9, 12) | (9, 11) | (8, 11) | (8, 10) | (8, 9) | (9, 9) | (9, 8) | (10, 8) | (10, 7) | (11, 7) | (12, 7) | (13, 7) | (13, 8) | (14, 8) | (15, 8) | (16, 8) | (16, 9) | (15, 9) | (15, 10) | (16, 10) | (16, 11) | (15, 11) | (14, 11) | (13, 11) | (13, 10) | (14, 10) | (14, 9) | (13, 9) | (12, 9) | (12, 8) | (11, 8) | (11, 9) | (10, 9) | (10, 10) | 
Pathways found------------------------
Shortest path-------------------------
