9 5 5 3 9 5 5 3 b 9 1 5 7 9 5 5 1 5 5 3 
e 9 3 c 6 9 7 a 8 6 a 9 5 6 9 3 c 7 9 2 
b a c 5 1 2 9 6 a b c 6 9 5 6 a 9 3 a a 
8 4 5 7 a a c 3 a 8 5 3 c 3 d 4 6 c 6 a 
a 9 5 5 2 c 7 a c 6 b a b c 5 5 3 9 5 6 
a a 9 7 a 9 5 6 9 7 8 6 8 5 5 7 a a d 3 
e a a 9 6 c 5 3 c 5 4 5 6 9 5 5 6 a 9 2 
9 6 8 6 9 3 f a 9 3 f f f 8 3 d 5 2 a a 
a b c 1 6 e f c 6 8 5 7 f e c 1 3 8 6 e 
a c 3 a 9 3 f f f a f f f 9 3 e a e 9 3 
c 3 8 6 a c 1 3 f a f d 5 2 c 3 c 5 6 a 
9 2 e 9 6 b a e f a f f f a d 4 5 5 3 a 
a a 9 6 d 2 c 5 3 a 9 3 d 2 9 3 9 3 c 2 
a a c 5 3 8 7 9 2 a a a 9 6 a c 6 c 3 e 
a c 3 9 6 a 9 6 e c 6 a c 5 6 9 5 3 c 3 
c 3 a a 9 2 c 5 1 5 7 a 9 5 5 6 b a 9 6 
9 2 e a a 8 5 3 c 3 9 6 c 3 9 1 6 a c 3 
a e 9 6 a c 3 a 9 6 c 3 9 6 a c 5 6 9 2 
8 3 a d 4 7 a a c 5 3 c 6 b a 9 3 d 2 a 
e c 4 5 5 5 6 c 5 7 c 5 5 4 4 6 c 5 6 e 
