9 7 d 5 3 
c 3 9 5 2 
b a 8 3 a 
8 6 e a a 
c 5 5 6 e 
