e f f 5 b f f f f f f f f f f f f f f f 
f b 9 4 4 b f f f f f f f f f f f f f f 
f c 6 f e 4 d 3 1 3 f f f f f f f f f f 
f f f f f a 1 -1e 1 6 b 3 7 f f f f f f f 
f f f f f d 0 2 7 8 5 5 f f f f f f f f 
f f f f f f d 1 5 e f f f f f f f f f f 
f f f f f f 9 6 f f f f f f f f f f f f 
f f f f f f a f f f f f f f f f f f f f 
f f f f f f b f f f f f f f f f f f f f 
f f f f f f a b f b 9 3 f f f f f f f f 
f f f f f 9 3 1 f c 6 c 7 f f f f f f f 
f f f f 5 4 4 2 f f f f a f f f f f f f 
f f f f a f a 3 f f 9 5 e f f f f f f f 
f f f f b f 4 8 -5 5 6 f f f f f f f f f 
f f f f c 5 c 7 d 6 f f f f f f f f f f 
f f f f f f f f f f f f f f f f f f f f 
f f f f f f f f f f f f f f f f f f f f 
f f f f f f f f f f f f f f f f f f f f 
f f f f f f f f f f f f f f f f f f f f 
f f f f f f f f f f f f f f f f f f f f 
